{
	"size": {
		"x": 16,
		"z": 16
	},
	"floor_tile_size": {
		"x": 8,
		"y": 8,
		"z": 8
	},
	"height_map": [
		0, 0, 0, 0  , 0, 0, 0, 0, 0, 0, 0, 0, 0, 0, 0, 0,
		0, 0, 0, 0  , 0, 0, 0, 0, 0, 0, 0, 0, 0, 0, 0, 0,
		1, 1, 1, 0  , 0, 1, 1, 1, 1, 1, 1, 1, 1, 1, 1, 1,
		0, 0, 0, 0  , 0, 0, 0, 0, 0, 0, 0, 0, 0, 0, 0, 0,
		0, 0, 0, 0  , 0, 0, 0, 0, 0, 0, 0, 0, 0, 0, 0, 0,
		0, 0, 1, 1  , 1, 0, 0, 0, 0, 0, 0, 0, 0, 0, 0, 0,
		0, 0, 1, 2  , 1, 1, 1, 1, 1, 1, 1, 1, 1, 1, 1, 1,
		0, 0, 1, 2  , 2, 2, 2, 2, 2, 2, 2, 2, 2, 2, 2, 2,
		0, 0, 1, 2  , 1, 1, 1, 1, 1, 1, 1, 1, 1, 1, 1, 1,
		0, 0, 1, 1  , 1, 0, 0, 0, 0, 0, 0, 0, 0, 0, 0, 0,
		0, 0, 0, 0.5, 0, 0, 0, 0, 0, 0, 0, 0, 0, 0, 0, 0,
		0, 0, 0, 0  , 0, 0, 0, 0, 0, 0, 0, 0, 0, 0, 0, 0,
		0, 0, 0, 0  , 0, 0, 0, 0, 0, 0, 0, 0, 0, 0, 0, 0,
		0, 0, 0, 0  , 0, 0, 0, 0, 0, 0, 0, 0, 0, 0, 0, 0,
		0, 0, 0, 0  , 0, 0, 0, 0, 0, 0, 0, 0, 0, 0, 0, 0,
		0, 0, 0, 0  , 0, 0, 0, 0, 0, 0, 0, 0, 0, 0, 0, 0
	],
	"base_position": {
		"x": 7,
		"z": 7
	},
	"starting_player_position": {
		"x": 10,
		"z": 10
	}
}
