{
	"size": {
		"x": 16,
		"z": 16
	},
	"height_map": [
		"0000000000000000",
		"0000000000000000",
		"0000000000000000",
		"0000000000000000",
		"0000000000000000",
		"0000001111100000",
		"0000001222100000",
		"0000001232100000",
		"0000001222100000",
		"0000001111100000",
		"0000000000000000",
		"0000000000000000",
		"0000000000000000",
		"0000000000000000",
		"0000000000000000",
		"0000000000000000"
	]
}
